#########
#       E
##  #  ##
S   #   #
#########