            #################                                       #  #     #      #
            #       #         ####################################  #  #     #    # #        
            #   #  E#         #                                  #  #      #####  # #    
            #   #####         ################################## #  # #           # #            
            #                 #                                # #       ##### #### #    
############################ ##################                # ##########     #   #         
#                                             #                # #        #     # ###
#       ##################                    #                # ######   #     #   #         
#                        #####       wkejbfcwe#                # #        #     ### ##
######################       #                #                # #   ######       # #             
#                            #                #                # #        #       # #
#################### ##########################                # ######   #       # #            
                #                       #                      # #        #       # #       
                #                       ######################## #   #######      # #         
                #             #     #   #                        #         #      # #
                ########      #     #   ################################## #      # #         
                #             #     #   #                                  #      # #
                #             #######   #           ###########################   # #                      
                #             #     #   #                                     #   # #
                #             #     ##############################            ##### #   
                #             #     # #S                                            # 
                #####################################################################