  #E#           
### ##############################################
#                       #                      # #
#             #     #   ######################## #
#             #     #                            #
############  #     #   ##########################
#             #     #   #
#             #######   #
#             #     #   #
#             #     #   #
#             #     #  S
#########################