#########
# ?     E
##  #  ##
S   #   #
#########